1111111111111111111111111111111111
1E1000000000000C00000C000000000011
100001010010000010100100000001011
1010010010101010001001000000010011
1P0000000C00C0000000000000000010C1
1111111111111111111111111111111111
