1111111111111111111111111111111111
1E00000000000000000000000000000011
1000010100110000010100100000001011
111001001010101000100100000001P011
1P000000000000000000000000000010C1
1111111111111111111111111111111111
